111111111111111
100C0000C111001
1P000C00000E001
111111111111111