111111111111111111111111
111111111000000000000001
1111111110000000N0000001
10000000000C000111100001
10000C000000000111100001
10000000000N000000000001
100001111111110000000001
100001111111110000000001
10000P0000000000C0000001
100000000011110000011111
1000N0000C11110000E11111
111111111111111111111111