111111111111111111111111
111111111E0000000000C001
1111111110000000N0000001
100000000000000111100001
10000000C000000111100001
10000000000N00000000C001
100001111111110000000001
100001111111110000C00001
100000000000000000000001
100000P000111100C0011111
1000N0000011110000011111
111111111111111111111111