11111111111
111111P0CE1
11111111111