111111111
1P0000C01
100000NE1
111111111