1111111111111
1PC0000000011
1EN00C0N00011
1111111111111
