111111111111
1000P0000001
100000000001
10C00C000001
100N00011111
10C0000E1111
111111111111