1111111111111
1PC0000000011
1E000C0000N11
1111111111111
