111111111111111111111111
11N1111110000N1000000001
11111111N0000000N0000001
10000000000C000111100001
10000C000000000111100001
10N00000N00N000000000001
100001111111110000000001
100001111111110000000001
10000P00000000000N000001
10000N000011110000011111
1000N00N0C11110001E11111
111111111111111111111111