111111111111111111111111
111111111N000C1000000001
111111110N00000000000001
10000000000C000111100001
10000C000000000111100001
10C00000N00N0000N0000001
100001111111110000000001
100001111111110000000001
10000P000000000000000001
100000000011110N00011111
100000000C11110000E11111
111111111111111111111111